"filename", "language", "JSON", "Markdown", "JavaScript", "HTML", "Vue", "comment", "blank", "total"
"d:\杨易卓-毕业论文\graduation-project\admin\README.md", "Markdown", 0, 20, 0, 0, 0, 0, 12, 32
"d:\杨易卓-毕业论文\graduation-project\admin\babel.config.js", "JavaScript", 0, 0, 5, 0, 0, 0, 1, 6
"d:\杨易卓-毕业论文\graduation-project\admin\package-lock.json", "JSON", 12615, 0, 0, 0, 0, 0, 1, 12616
"d:\杨易卓-毕业论文\graduation-project\admin\package.json", "JSON", 54, 0, 0, 0, 0, 0, 1, 55
"d:\杨易卓-毕业论文\graduation-project\admin\public\index.html", "HTML", 0, 0, 0, 28, 0, 1, 3, 32
"d:\杨易卓-毕业论文\graduation-project\admin\src\App.vue", "Vue", 0, 0, 0, 0, 64, 14, 4, 82
"d:\杨易卓-毕业论文\graduation-project\admin\src\components\add-dialog.vue", "Vue", 0, 0, 0, 0, 259, 22, 10, 291
"d:\杨易卓-毕业论文\graduation-project\admin\src\components\background-box.vue", "Vue", 0, 0, 0, 0, 65, 0, 5, 70
"d:\杨易卓-毕业论文\graduation-project\admin\src\components\no-data.vue", "Vue", 0, 0, 0, 0, 11, 0, 3, 14
"d:\杨易卓-毕业论文\graduation-project\admin\src\components\search-box.vue", "Vue", 0, 0, 0, 0, 56, 8, 4, 68
"d:\杨易卓-毕业论文\graduation-project\admin\src\components\upload.vue", "Vue", 0, 0, 0, 0, 94, 7, 4, 105
"d:\杨易卓-毕业论文\graduation-project\admin\src\lib\config.js", "JavaScript", 0, 0, 59, 0, 0, 0, 0, 59
"d:\杨易卓-毕业论文\graduation-project\admin\src\main.js", "JavaScript", 0, 0, 41, 0, 0, 18, 5, 64
"d:\杨易卓-毕业论文\graduation-project\admin\src\router\index.js", "JavaScript", 0, 0, 87, 0, 0, 19, 5, 111
"d:\杨易卓-毕业论文\graduation-project\admin\src\store\index.js", "JavaScript", 0, 0, 44, 0, 0, 4, 6, 54
"d:\杨易卓-毕业论文\graduation-project\admin\src\utils\http.js", "JavaScript", 0, 0, 37, 0, 0, 5, 5, 47
"d:\杨易卓-毕业论文\graduation-project\admin\src\utils\rem.js", "JavaScript", 0, 0, 9, 0, 0, 7, 0, 16
"d:\杨易卓-毕业论文\graduation-project\admin\src\views\admin-management.vue", "Vue", 0, 0, 0, 0, 380, 16, 20, 416
"d:\杨易卓-毕业论文\graduation-project\admin\src\views\check-record.vue", "Vue", 0, 0, 0, 0, 272, 8, 12, 292
"d:\杨易卓-毕业论文\graduation-project\admin\src\views\detail-pages\detail.vue", "Vue", 0, 0, 0, 0, 487, 23, 31, 541
"d:\杨易卓-毕业论文\graduation-project\admin\src\views\detail-pages\personal-dynamic.vue", "Vue", 0, 0, 0, 0, 384, 21, 15, 420
"d:\杨易卓-毕业论文\graduation-project\admin\src\views\detail-pages\personal.vue", "Vue", 0, 0, 0, 0, 285, 18, 8, 311
"d:\杨易卓-毕业论文\graduation-project\admin\src\views\dynamic-management.vue", "Vue", 0, 0, 0, 0, 435, 11, 26, 472
"d:\杨易卓-毕业论文\graduation-project\admin\src\views\handle-problem.vue", "Vue", 0, 0, 0, 0, 307, 11, 25, 343
"d:\杨易卓-毕业论文\graduation-project\admin\src\views\header.vue", "Vue", 0, 0, 0, 0, 100, 5, 4, 109
"d:\杨易卓-毕业论文\graduation-project\admin\src\views\index.vue", "Vue", 0, 0, 0, 0, 139, 1, 9, 149
"d:\杨易卓-毕业论文\graduation-project\admin\src\views\login.vue", "Vue", 0, 0, 0, 0, 146, 5, 10, 161
"d:\杨易卓-毕业论文\graduation-project\admin\src\views\navbar.vue", "Vue", 0, 0, 0, 0, 85, 1, 5, 91
"d:\杨易卓-毕业论文\graduation-project\admin\src\views\notFound.vue", "Vue", 0, 0, 0, 0, 16, 0, 3, 19
"d:\杨易卓-毕业论文\graduation-project\admin\src\views\reply-management.vue", "Vue", 0, 0, 0, 0, 337, 10, 15, 362
"d:\杨易卓-毕业论文\graduation-project\admin\src\views\user-management.vue", "Vue", 0, 0, 0, 0, 433, 11, 31, 475
"d:\杨易卓-毕业论文\graduation-project\admin\vue.config.js", "JavaScript", 0, 0, 21, 0, 0, 4, 2, 27
"Total", "-", 12669, 20, 303, 28, 4355, 250, 285, 17910